COM = "countries/Comitet oborony.txt"
VPA = "countries/Vremennoe Pravitelstvo.txt"
SCA = "countries/Social commune.txt"
GEL = "countries/Gelden.txt"
KIL = "countries/Kilka.txt"
VOR = "countries/Voruga.txt"
XAM = "countries/Xamardos.txt"
WER = "countries/Wervol.txt"
AMI = "countries/Amina.txt"
KOT = "countries/Kote.txt"
PSI = "countries/Psi.txt"
HEC = "countries/Hecesper.txt"
HLD = "countries/Holodok.txt"
GUP = "countries/Gupka.txt"
JBL = "countries/Just Bill.txt"
DKK = "countries/Domik.txt"
FLK = "countries/Flok.txt"
SAL = "countries/Salo.txt"
EZO = "countries/Ezio.txt"
KIT = "countries/Kitik.txt"
DCD = "countries/dcocd.txt"
SHA = "countries/Sheba.txt"
NZR = "countries/Nadzor.txt"
VEX = "countries/VEX.txt"
STO = "countries/Sato.txt"
GUS = "countries/Guse.txt"
TBL = "countries/ToblBobl.txt"
BAR = "countries/Barioshy.txt"
DVL = "countries/Devil.txt"
DYA = "countries/Dyavol.txt"
ACK = "countries/Ackpi.txt"
ANA = "countries/Anime.txt"
KTA = "countries/Kitai.txt"
CLS = "countries/ClearSky.txt"
NKT = "countries/Nikitok.txt"
AKT = "countries/Arkatank.txt"
YNO = "countries/Yuno.txt"
DCK = "countries/Duck.txt"
CWR = "countries/Clowner.txt"
RMX = "countries/Relmax.txt"
PSY = "countries/Personality.txt"